1111111111111
10010000001E1
1000011110101
1P0011CCC0001
1111111111111