1111111111111111111
1000000000C001E1111
1000000000000100001
1000000000000100001
10000C0C0C0C0000001
10000C0C0C0C0000001
10000C0C0C0C0000001
10000C0C0C0C0000001
10000C0C0P0C0000001
10000C0C0C0C0001111
10000C0C0C0C0001C01
1111111111111111111