1111111111111111111111
101CCC1111101110111111
10101011111111111E1011
100C000P00000000100011
1011101011111010111011
1111111011101010001011
1000111011111010111011
1010101011111110101011
1110111010001010111011
1000CC0C10101000000011
1111111111111111111111